15x15* +][
***************
*     *      **
**       *    *
**           **
*        *    *
*  *        ***
* *       **  [
*       *     *
**   *      * *
*     *       *
*       *   * *
*  *    *  *  *
] *   *    *  *
*  **  *     **
******[********